+----------+
|c***@*====|
|m***=*====|
|===*=**==c|
|===*======|
|===*m=====|
|===*****==|
|==========|
|=*==*=m===|
|=*==*===d=|
|=*cc*=*===|
+----------+
