+----------+
|==**@d====|
|=====*==c=|
|=========c|
|==========|
|====c=====|
|=======*==|
|===c======|
|======mc==|
|==========|
|==c=*=*===|
+----------+
