+----------+
|====**=*==|
|======m===|
|=m=c======|
|@=====cc==|
|==========|
|==========|
|*===d===cc|
|====c=====|
|==*====m==|
|c===d=====|
+----------+
