+----------+
|=====*====|
|======*m=*|
|==*=======|
|===c=m====|
|====m===@=|
|m=========|
|*m===c=mc=|
|==========|
|cd==c=c===|
|==d=*=====|
+----------+
